00000000WWWWWWWW0000
00000000WFFFFF@W0000
00000000WFOWOFWW0000
00000000WFOFFOW00000
00000000WWOFOFW00000
WWWWWWWWWFOFWFWWW000
WXXXXFFWWFOFFOFFW000
WWXXXFFFFOFFOFFFW000
WXXXXFFWWWWWWWWWW000
WWWWWWWW000000000000
00000000000000000000
00000000000000000000
00000000000000000000
00000000000000000000
00000000000000000000
00000000000000000000
00000000000000000000
00000000000000000000
00000000000000000000
00000000000000000000