0000WWWWW00000000000
0000WFFFW00000000000
0000WOFFW00000000000
00WWWFFOWW0000000000
00WFFOFOFW0000000000
WWWFWFWWFW000WWWWWW0
WFFFWFWWFWWWWWFFXXW0
WFOFFOFFFFFFFFFFXXW0
WWWWWFWWWFW@WWFFXXW0
0000WFFFFFWWWWWWWWW0
0000WWWWWWW000000000
00000000000000000000
00000000000000000000
00000000000000000000
00000000000000000000
00000000000000000000
00000000000000000000
00000000000000000000
00000000000000000000
00000000000000000000