00000000000000000000
00000000000000000000
00000000000000000000
00000000000000000000
00000WWW000000000000
00000WXW000000000000
00000WFW000000000000
00000WFW000000000000
00000WFW000000000000
000WWWFW000000000000
000WFFOW000000000000
000W@FFW000000000000
000WWWWW000000000000
00000000000000000000
00000000000000000000
00000000000000000000
00000000000000000000
00000000000000000000
00000000000000000000
00000000000000000000